1111111111111
10010000C00C1
1111111111111
1000011111001
1P0011E00P001
1Pc011000P001
10001100cc001
1111111111111
