1111111111111
10010000000C1
1000011111001
11110C000C0C1
10C0011111111
1P0000000C001
100C0000000C1
10011E0000011
1111111111111