11111111111111111111
1000000CC0I0CC000001
11111011111111101111
1P1000I0000C0000C001
1000000000E00010I001
11111111111111111111