11111111111111
10010000000CI1
100001111100C1
1P0011E0000001
101000I0000C01
10CCC0I0000001
11111111111111