1111111111111111
1111000000000000000
11111100000C00001
111110000011100000
111111P000000CCC1
11111000000011111
11111111111111111