1111111111111111111111111111
1E0010C0010000C0C00000100001
1000111001000000000011100001
1P000000010C010C0C0C00000001
100001110000010000CC00001111
100C000100000100000000000001
1111111111111111111111111111