1111111111111111111111111111
1E0010C001I000C0C0I000100001
10001110010000C0000011100001
1P0000I0010C00000C0C00000001
100000C00C00011100CC00001111
100C00I00C0I0100000II0000001
1111111111111111111111111111